0 1 1 1 1 1 1 1 1 1
0 1 1 0 0 0 4 0 0 0
0 1 1 0 1 0 1 0 1 0
0 3 3 1 4 0 0 0 4 0
0 1 1 0 1 1 1 1 1 0
0 1 0 2 6 0 5 0 0 0
0 1 1 1 1 1 0 1 1 1
0 1 0 0 0 1 0 0 0 1
0 1 0 1 0 1 1 1 0 1
0 0 0 1 0 0 0 0 0 0
